Structured comment name	Value syntax	Example																										
abs_air_humidity	{float} {unit}	9 gram per gram																										
adapters	"{dna},{dna}"																											
add_recov_method	[Water Injection|Dump Flood|Gas Injection|Wag Immiscible Injection|Polymer Addition|Surfactant Addition|Not Applicable|other];{timestamp}	Polymer Addition;2018-06-21T14:30Z																										
additional_info	{text}																											
address	{integer}{text}																											
adj_room	{text};{integer}																											
adjacent_environment	{termLabel}{[termID]}	estuarine biome [ENVO:01000020]																										
aero_struc	[plane|glider]	plane																										
agrochem_addition	{text};{float} {unit};{timestamp}	roundup;5 milligram per liter;2018-06-21																										
agrochem_addition	{text};{float} {unit};{timestamp}																											
air particulate matter concentration	{text};{float} {unit}	PM2.5;10 microgram per cubic meter																										
air_flow_impede	[obstructed|unobstructed]; {text}; {measurement value}	obstructed;hay bales; 2 m																										
air_PM_concen	{text};{float} {unit}	PM2.5;10 microgram per cubic meter																										
air_temp	{float} {unit}	20 degree Celsius																										
air_temp	{float} {unit}	4 degree Celsius																										
air_temp_regm	{float} {unit};{Rn/start_time/end_time/duration}	25 degree Celsius;R2/2018-05-11T14:30/2018-05-11T19:30/P1H30M																										
al_sat	{float} {unit}																											
al_sat_meth	{PMID}|{DOI}|{URL}																											
alkalinity	{float} {unit}	50 milligram per liter																										
alkalinity_method	{text}	titration																										
alkyl_diethers	{float} {unit}	0.005 mole per liter																										
alt	{float} {unit}	100 meter																										
aminopept_act	{float} {unit}	0.269 mole per liter per hour																										
ammonium	{float} {unit}	1.5 milligram per liter																										
amniotic_fluid_color	{text}																											
amount_light	{float} {unit}																											
ances_data	{text}	A/3*B																										
anim_water_method	{termLabel} {[termID]}	water trough [EOL:0001618]																										
animal_am	{text}	tetracycline																										
animal_am_dur	{float} {day}	3 days																										
animal_am_freq	{float} {unit}	once daily																										
animal_am_route	{text}	oral-feed																										
animal_am_use	{text}	shipping fever																										
animal_body_cond	[normal|over conditioned|under conditioned]	under conditioned																										
animal_diet	{text}	Hay [FOODON_03301763]																										
animal_diet	{text}	Hay [FOODON:03301763]																										
animal_feed_equip	{termLabel} {[termID]}	self feeding [EOL:0001645]| straight feed trough [EOL:0001661]																										
animal_feed_equip	{termLabel}{[termID]}	self feeding [EOL:0001645]| straight feed trough [EOL:0001661]																										
animal_group_size	{integer}	80																										
animal_housing	{termLabel} {[termID]}	pen rearing system [EOL:0001636]																										
animal_intrusion	{termLabel} {[termID]}|{integer}	Thripidae [NCBITaxon:45053]																										
animal_sex	[castrated female|castrated male|intact female|intact male]	castrated male																										
annot	{text}																											
annual_precpt	{float} {unit}																											
annual_temp	{float} {unit}	12.5 degree Celsius																										
antibiotic_regm	{text};{float} {unit};{Rn/start_time/end_time/duration}	penicillin;5 milligram;R2/2018-05-11T14:30/2018-05-11T19:30/P1H30M																										
api	{float} {unit}																											
arch_struc	[building|shed|home]	shed																										
area_samp_size	{integer} {unit} x {integer} {unit}	12 centimeter x 12 centimeter																										
aromatics_pc	{text};{float} {unit}																											
asphaltenes_pc	{text};{float} {unit}																											
assembly_name	{text} {text}	"HuRef, JCVI_ISG_i3_1.0"																										
assembly_quality	{software};{version};{parameters}	"metaSPAdes;3.11.0;kmer set 21,33,55,77,99,121, default parameters otherwise"																										
assembly_software	[Finished genome|High-quality draft genome|Medium-quality draft genome|Low-quality draft genome|Genome fragment(s)]	High-quality draft genome																										
association_duration	{float} {unit}																											
atmospheric_data	{text};{float} {unit}	wind speed;9 knots																										
avg_dew_point	{float} {unit}	25.5 degree Celsius																										
avg_occup	{float}	2																										
avg_occup	{float}	6																										
avg_temp	{float} {unit}	12.5 degree Celsius																										
bac_prod	{float} {unit}	5 milligram per cubic meter per day																										
bac_resp	{float} {unit}	300 micromole oxygen per liter per hour																										
bacteria_carb_prod	{float} {unit}	2.53 microgram per liter per hour																										
bacterial_density	{float} {unit}	10 colony forming units per gram dry weight																										
barometric_press	{float} {unit}	5 millibar																										
basin	{text}																											
bathroom_count	{integer}	1																										
bedroom_count	{integer}	2																										
benzene	{float} {unit}																											
biochem_oxygen_dem	{float} {unit}																											
biocide	{text};{text};{timestamp}	ALPHA 1427;Baker Hughes;2008-01-23																										
biocide_admin_method	{float} {unit};{Rn/start_time/end_time/duration};{duration}																											
biocide_used	{text}	Quaternary ammonium compound|SterBac																										
biol_stat	[wild|natural|semi-natural|inbred line|breeder's line|hybrid|clonal selection|mutant]	natural																										
biomass	{text};{float} {unit}	total;20 gram																										
biotic_regm	{text}	sample inoculated with Rhizobium spp. Culture																										
biotic_relationship	[free living|parasite|commensal|symbiont]																											
birth_control	{text}																											
bishomohopanol	{float} {unit}	14 microgram per liter																										
blood_blood_disord	{text}																											
blood_press_diast	{float} {unit}																											
blood_press_syst	{float} {unit}																											
bromide	{float} {unit}	0.05 parts per million																										
build_docs	[building information model|commissioning report|complaint logs|contract administration|cost estimate|janitorial schedules or logs|maintenance plans|schedule|sections|shop drawings|submittals|ventilation system|windows]	maintenance plans																										
build_occup_type	[office|market|restaurant|residence|school|residential|commercial|low rise|high rise|wood framed|office|health care|school|airport|sports complex]	market																										
building_setting	[urban|suburban|exurban|rural]	rural																										
built_struc_age	{float} {unit}	15																										
built_struc_set	[urban|rural]	rural																										
built_struc_type	{text}																											
calcium	{float} {unit}	0.2 micromole per liter																										
carb_dioxide	{float} {unit}	410 parts per million																										
carb_monoxide	{float} {unit}	0.1 parts per million																										
carb_nitro_ratio	{float} {unit}	0.417361111																										
carb_nitro_ratio	{float}:{float}	0.417361111																										
ceil_area	{float} {unit}	25 square meter																										
ceil_cond	[new|visible wear|needs repair|damaged|rupture]	damaged																										
ceil_finish_mat	[drywall|mineral fibre|tiles|PVC|plasterboard|metal|fiberglass|stucco|mineral wool/calcium silicate|wood]	stucco																										
ceil_struc	[wood frame|concrete]	concrete																										
ceil_texture	[crows feet|crows-foot stomp|double skip|hawk and trowel|knockdown|popcorn|orange peel|rosebud stomp|Santa-Fe texture|skip trowel|smooth|stomp knockdown|swirl]	popcorn																										
ceil_thermal_mass	{float} {unit}																											
ceil_type	[cathedral|dropped|concave|barrel-shaped|coffered|cove|stretched]	coffered																										
ceil_water_mold	[presence of mold visible|no presence of mold visible]	presence of mold visible																										
chem_administration	{termLabel} {[termID]};{timestamp}	agar [CHEBI:2509];2018-05-11T20:00Z																										
chem_administration	{termLabel} {[termID]};{timestamp}																											
chem_mutagen	{text};{float} {unit};{Rn/start_time/end_time/duration}	nitrous acid;0.5 milligram per liter;R2/2018-05-11T14:30/2018-05-11T19:30/P1H30M																										
chem_oxygen_dem	{float} {unit}																											
chem_treat_method	{float} {unit};{Rn/start_time/end_time/duration};{duration};{duration}																											
chem_treatment	{text};{text};{timestamp}	ACCENT 1125;DOW;2010-11-17																										
chimera_check	{text} {text}																											
chloride	{float} {unit}	5000 milligram per liter																										
chlorophyll	{float} {unit}	5 milligram per cubic meter																										
climate_environment	{text};{period};{interval};{period}																											
climate_environment	{text};{Rn/start_time/end_time/duration}	tropical climate;R2/2018-05-11T14:30/2018-05-11T19:30/P1H30M																										
coll_site_geo_feat	{text}|{termLabel} {[termID]}	grocery store [ENVO:01000984]																										
coll_site_geo_feat	{text}|{termLabel} {[termID]}	grocery store [GENEPIO:0001020]																										
collection_date	{timestamp}	2018-05-11T10:00:00+01:00																										
collection_date	{timestamp}	2018-05-11T10:00:00+01:00; 2018-05-11																										
conduc	{float} {unit}	10 milliSiemens per centimeter																										
cons_food_stor_dur	{duration}	P5D																										
cons_food_stor_temp	{float} {unit}|{text}	4 degree Celsius																										
cons_purch_date	{timestamp}	11/30/19																										
cons_qty_purchased	{integer} {unit}	5 cans																										
cool_syst_id	{integer}	12345																										
crop_rotation	{boolean};{Rn/start_time/end_time/duration}	yes;R2/2017-01-01/2018-12-31/P6M																										
crop_rotation	{boolean};Rn/{timestamp}/{period}																											
crop_yield	{float}{unit}	570 kilogram per metre square																										
cult_isol_date	{timestamp}	2018-05-11T10:00:00+01:00																										
cult_isol_date	YYYY-MM-DD	2/26/20																										
cult_result	[absent|active|inactive|negative|no|present|positive|yes]	positive																										
cult_result_org	{termLabel} {[termID]}|{integer}	Listeria monocytogenes [NCIT:C86502]																										
cult_root_med	{text}|{PMID}|{DOI}|{URL}	http://himedialabs.com/TD/PT158.pdf																										
cult_target	{termLabel} {[termID]}|{integer}	Listeria monocytogenes [NCIT:C86502]																										
cur_land_use	"[cities|farmstead|industrial areas|roads/railroads|rock|sand|gravel|mudflats|salt flats|badlands|permanent snow or ice|saline seeps|mines/quarries|oil waste areas|small grains|row crops|vegetable crops|horticultural plants (e.g. tulips)|marshlands (grass,sedges,rushes)|tundra (mosses,lichens)|rangeland|pastureland (grasslands used for livestock grazing)|hayland|meadows (grasses,alfalfa,fescue,bromegrass,timothy)|shrub land (e.g. mesquite,sage-brush,creosote bush,shrub oak,eucalyptus)|successional shrub land (tree saplings,hazels,sumacs,chokecherry,shrub dogwoods,blackberries)|shrub crops (blueberries,nursery ornamentals,filberts)|vine crops (grapes)|conifers (e.g. pine,spruce,fir,cypress)|hardwoods (e.g. oak,hickory,elm,aspen)|intermixed hardwood and conifers|tropical (e.g. mangrove,palms)|rainforest (evergreen forest receiving >406 cm annual rainfall)|swamp (permanent or semi-permanent water body dominated by woody plants)|crop trees (nuts,fruit,christmas trees,nursery trees)]"	conifers																										
cur_land_use	"[cities|farmstead|industrial areas|roads/railroads|rock|sand|gravel|mudflats|salt flats|badlands|permanent snow or ice|saline seeps|mines/quarries|oil waste areas|small grains|row crops|vegetable crops|horticultural plants (e.g. tulips)|marshlands (grass,sedges,rushes)|tundra (mosses,lichens)|rangeland|pastureland (grasslands used for livestock grazing)|hayland|meadows (grasses,alfalfa,fescue,bromegrass,timothy)|shrub land (e.g. mesquite,sage-brush,creosote bush,shrub oak,eucalyptus)|successional shrub land (tree saplings,hazels,sumacs,chokecherry,shrub dogwoods,blackberries)|shrub crops (blueberries,nursery ornamentals,filberts)|vine crops (grapes)|conifers (e.g. pine,spruce,fir,cypress)|hardwoods (e.g. oak,hickory,elm,aspen)|intermixed hardwood and conifers|tropical (e.g. mangrove,palms)|rainforest (evergreen forest receiving >406 cm annual rainfall)|swamp (permanent or semi-permanent water body dominated by woody plants)|crop trees (nuts,fruit,christmas trees,nursery trees)]"																											
cur_vegetation	{text}																											
cur_vegetation_meth	{PMID}|{DOI}|{URL}																											
cur_vegetation_meth	{PMID|DOI|URL}																											
date_extr_weath	{timestamp}	2018-05-11:T14:30Z																										
date_last_rain	{timestamp}	2018-05-11:T14:30Z																										
density	{float} {unit}	1000 kilogram per cubic meter																										
depos_env	[Continental - Alluvial|Continental - Aeolian|Continental - Fluvial|Continental - Lacustrine|Transitional - Deltaic|Transitional - Tidal|Transitional - Lagoonal|Transitional - Beach|Transitional - Lake|Marine - Shallow|Marine - Deep|Marine - Reef|Other - Evaporite|Other - Glacial|Other - Volcanic|other]	Continental - Alluvial																										
depos_env	[Continental - Alluvial|Continental - Aeolian|Continental - Fluvial|Continental - Lacustrine|Transitional - Deltaic|Transitional - Tidal|Transitional - Lagoonal|Transitional - Beach|Transitional - Lake|Marine - Shallow|Marine - Deep|Marine - Reef|Other - Evaporite|Other - Glacial|Other - Volcanic|other]	Marine - Reef																										
depth	{float} {unit}	10 meter																										
dermatology_disord	{text}																											
dew_point	{float} {unit}	22 degree Celsius																										
diet_last_six_month	{boolean};{text}	yes;vegetarian diet																										
dietary_claim_use	{text}|{termLabel} {[termID]}	No preservatives [FOODON:03510113]																										
diether_lipids	{text};{float} {unit}	0.2 nanogram per liter																										
diss_carb_dioxide	{float} {unit}	5 milligram per liter																										
diss_hydrogen	{float} {unit}	0.3 micromole per liter																										
diss_inorg_carb	{float} {unit}	2059 micromole per kilogram																										
diss_inorg_nitro	{float} {unit}	761 micromole per liter																										
diss_inorg_phosp	{float} {unit}	56.5 micromole per liter																										
diss_iron	{float} {unit}																											
diss_org_carb	{float} {unit}	197 micromole per liter																										
diss_org_nitro	{float} {unit}	0.05 micromole per liter																										
diss_oxygen	{float} {unit}	175 micromole per kilogram																										
diss_oxygen_fluid	{float} {unit}																											
dominant_hand	[left|right|ambidextrous]	right																										
door_comp_type	[metal covered|revolving|sliding|telescopic]	revolving																										
door_cond	[damaged|needs repair|new|rupture|visible wear]	new																										
door_direct	[inward|outward|sideways]	inward																										
door_loc	[north|south|east|west]	north																										
door_mat	[aluminum|cellular PVC|engineered plastic|fiberboard|fiberglass|metal|thermoplastic alloy|vinyl|wood|wood/plastic composite]	wood																										
door_move	[collapsible|folding|revolving|rolling shutter|sliding|swinging]	swinging																										
door_size	{float} {unit}	2.5 square meter																										
door_type	[composite|metal|wooden]	wooden																										
door_type_metal	[collapsible|corrugated steel|hollow|rolling shutters|steel plate]	hollow																										
door_type_wood	"[bettened and ledged|battened|ledged and braced|battened|ledged and framed|battened|ledged, braced and frame|framed and paneled|glashed or sash|flush|louvered|wire gauged]"	battened																										
door_water_mold	[presence of mold visible|no presence of mold visible]	presence of mold visible																										
douche	{timestamp}	5/11/18																										
down_par	{float} {unit}	28.71 microEinstein per square meter per second																										
drainage_class	[very poorly|poorly|somewhat poorly|moderately well|well|excessively drained]	well																										
drainage_class	[very poorly|poorly|somewhat poorly|moderately well|well|excessively drained]																											
drawings	[operation|as built|construction|bid|design|building navigation map|diagram|sketch]	sketch																										
drug_usage	{text};{integer}/[year|month|week|day|hour]	Lipitor;2/day																										
efficiency_percent	{float} {unit}																											
elev	{float} {unit}	100 meter																										
elevator	{integer}	2																										
emulsions	{text};{float} {unit}																											
enrichment_protocol	{PMID}|{DOI}|{URL}|{text}	BAM Chapter 4: Enumeration of Escherichia coli and the Coliform Bacteria																										
env_broad_scale	{termLabel} {[termID]}	forest biome [ENVO:01000174]																										
env_broad_scale	{termLabel} {[termID]}	oceanic epipelagic zone biome [ENVO:01000033] for annotating a water sample from the photic zone in middle of the Atlantic Ocean																										
env_local_scale	{termLabel} {[termID]}	litter layer [ENVO:01000338]																										
env_local_scale	{termLabel} {[termID]}	litter layer [ENVO:01000338]; Annotating a pooled sample taken from various vegetation layers in a forest consider: canopy [ENVO:00000047]|herb and fern layer [ENVO:01000337]|litter layer [ENVO:01000338]|understory [01000335]|shrub layer [ENVO:01000336].																										
env_medium	{termLabel} {[termID]}	intestine environment [ENVO:2100002]																										
env_medium	{termLabel} {[termID]}	soil [ENVO:00001998]																										
env_medium	{termLabel} {[termID]}	"soil [ENVO:00001998]; Annotating a fish swimming in the upper 100 m of the Atlantic Ocean, consider: ocean water [ENVO:00002151]. Example: Annotating a duck on a pond consider: pond water [ENVO:00002228]|air [ENVO_00002005]"																										
env_monitoring_zone	{termLabel} {[termID]}	Zone 1																										
escalator	{integer}	4																										
ethnicity	{text}	native american																										
ethylbenzene	{float} {unit}																											
exp_duct	{float} {unit}																											
exp_pipe	{integer}																											
experimental_factor	{termLabel} {[termID]}|{text}	time series design [EFO:0001779]																										
experimental_factor	{termLabel} {[termID]}|{text}	time series design [EFO:EFO_0001779]																										
ext_door	{integer}																											
ext_wall_orient	[north|south|east|west|northeast|southeast|southwest|northwest]	northwest																										
ext_window_orient	[north|south|east|west|northeast|southeast|southwest|northwest]	southwest																										
extr_weather_event	[drought|dust storm|extreme cold|extreme heat|flood|frost|hail|high precipitationhigh winds]	hail																										
extreme_event	{timestamp}																											
facility_type	[ambient storage|caterer-catering point|distribution|frozen storage|importer-broker|interstate conveyance|labeler-relabeler|manufacturing-processing|packaging|refrigerated storage|storage]	manufacturing-processing																										
fao_class	[Acrisols|Andosols|Arenosols|Cambisols|Chernozems|Ferralsols|Fluvisols|Gleysols|Greyzems|Gypsisols|Histosols|Kastanozems|Lithosols|Luvisols|Nitosols|Phaeozems|Planosols|Podzols|Podzoluvisols|Rankers|Regosols|Rendzinas|Solonchaks|Solonetz|Vertisols|Yermosols]	Luvisols																										
fao_class	{term}																											
farm_equip	{termLabel} {[termID]}	combine harvester [AGRO:00000473]																										
farm_equip_san	{text} {float} {unit}	"hot water pressure wash, hypochlorite solution, 50 parts per million"																										
farm_equip_san																												
farm_equip_san_freq	{text}	Biweekly																										
farm_equip_shared	{termLabel} {[termID]}	combine harvester [AGRO:00000473]																										
farm_equip_shared																												
farm_water_source	[freshwater|brackish|saline|natural|manmade|estuary|lake|pond|canal|stream|river|melt pond|well|ditch|reservior|collected rainwater|municipal|storage tank]	water well (ENVO:01000002)																										
ferm_chem_add	{float} {unit}	salt																										
ferm_chem_add_perc	{float} percentage	1%																										
ferm_headspace_oxy	{float} percentage	5%																										
ferm_medium	{text}	molasses																										
ferm_pH	{float}	4.5																										
ferm_rel_humidity	{float} {unit}	95% RH																										
ferm_temp	{float} {unit}	22 degrees Celsius																										
ferm_time	{duration}	P10D																										
ferm_vessel	{text}	steel drum																										
fertilizer_admin	{termLabel} {[termID]}	fish emulsion [AGRO:00000082]																										
fertilizer_date	{timestamp}	2018-05-11T10:00:00+01:00																										
fertilizer_regm	{text};{float} {unit};{Rn/start_time/end_time/duration}	urea;0.6 milligram per liter;R2/2018-05-11:T14:30/2018-05-11T19:30/P1H30M																										
field	{text}																											
filter_type	[particulate air filter|chemical air filter|low-MERV pleated media|HEPA|electrostatic|gas-phase or ultraviolet air treatments]	HEPA																										
fire	{timestamp}																											
fireplace_type	[gas burning|wood burning]	wood burning																										
flooding	{timestamp}																											
floor_age	{float} {unit}																											
floor_area	{float} {unit}																											
floor_cond	[new|visible wear|needs repair|damaged|rupture]	new																										
floor_count	{integer}																											
floor_finish_mat	[tile|wood strip or parquet|carpet|rug|laminate wood|lineoleum|vinyl composition tile|sheet vinyl|stone|bamboo|cork|terrazo|concrete|none;specify unfinished|sealed|clear finish|paint]	carpet																										
floor_struc	[balcony|floating floor|glass floor|raised floor|sprung floor|wood-framed|concrete]	concrete																										
floor_thermal_mass	{float} {unit}																											
floor_water_mold	[mold odor|wet floor|water stains|wall discoloration|floor discoloration|ceiling discoloration|peeling paint or wallpaper|bulging walls|condensation]	ceiling discoloration																										
fluor	{float} {unit}	2.5 volts																										
foetal_health_stat	{text}																											
food_additive	{text}|{termLabel} {[termID]}	xanthan gum [FOODON_03413321]																										
food_additive	{text}|{termLabel} {[termID]}	xanthan gum [FOODON:03413321]																										
food_allergen_label	{text}|{termLabel} {[termID]}	food allergen labelling about crustaceans and products thereof [FOODON:03510215]																										
food_clean_proc	[drum and drain|manual spinner|rinsed with sanitizer solution|rinsed with water|scrubbed with brush|scrubbed with hand|soaking]	rinsed with water|scrubbed with brush																										
food_contact_surf	{text}|{termLabel} {[termID]}	cellulose acetate [FOODON:03500034]																										
food_contain_wrap	{text}|{termLabel} {[termID]}	Plastic shrink-pack [FOODON:03490137]																										
food_cooking_proc	{text}|{termLabel} {[termID]}	food blanching [FOODON:03470175]																										
food_dis_point	"{term}: {term}, {text}"	"USA: Delmarva Peninsula or USA: Georgia, Atlanta [GAZ:00004445]"																										
food_dis_point	"{term}: {term}, {text}"	"USA: Delmarva, Peninsula"																										
food_dis_point	"{term}: {term}, {text}"	"USA:Delmarva, Peninsula"																										
food_dis_point_city	{text}|{termLabel} {[termID]}	Atlanta[GAZ:00004445]																										
food_harvest_proc	{text}	hand-picked																										
food_harvest_proc																												
food_ingredient	{text}|{termLabel} {[termID]}	bean (whole) [FOODON:00002753]																										
food_name_status	{termLabel} {[termID]}	protected geographic indication [FOODON:03530256]																										
food_origin	"{term}: {term}, {text}"	"USA: Delmarva, Peninsula"																										
food_origin	"{term}:{term}, {text}"	"USA:Delmarva, Peninsula"																										
food_pack_capacity	{float} {unit}	454 grams																										
food_pack_integrity	{text}|{termLabel} {[termID]}	food packing medium compromised [FOODON:00002517]																										
food_pack_medium	{text}|{termLabel} {[termID]}	packed in fruit juice [FOODON:03480039]																										
food_pack_medium	{text}|{termLabel} {[termID]}	vacuum-packed [FOODON:03480027]																										
food_pack_medium	{text}|{termLabel} {[termID]}	vacuum-packed[FOODON:03480027]																										
food_preserv_proc	{text}|{termLabel} {[termID]}	food slow freezing [FOODON:03470128]																										
food_prior_contact	{text}|{termLabel} {[termID]}	processed in stainless steel container [FOODON:03530081]																										
food_prod	{termLabel} {[termID]}	organic plant cultivation [FOODON:03530253]																										
food_prod_char	{text}	wild caught																										
food_prod_synonym	{text}	pinot gris																										
food_product_qual	{termLabel} {[termID]}	raw [FOODON:03311126]																										
Food_Product_type	{text}	delicatessen salad; FOODON:03316276																										
food_product_type	{text}|{termLabel} {[termID]}	"shrimp (peeled, deep-frozen) [FOODON:03317171]"																										
food_quality_date	[best by|best if used by|freeze by||use by]; date	best by 2020-05-24																										
food_source	{termLabel} {[termID]}	giant tiger prawn [FOODON:03412612]																										
Food_source	{text}	red swamp crayfish; FOODON:03412231																										
food_source_age	{float} {unit}	P6M																										
food_trace_list	[cheeses-other than hard cheeses|cucumbers|crustaceans|finfish-including smoked finfish|fruits and vegetables-fresh cut|herbs-fresh|leafy greens-including fresh cut leafy greens|melons|mollusks-bivalves|nut butter|peppers|ready to eat deli salads|sprouts|tomatoes|tropical tree fruits|shell eggs]	tropical tree fruits																										
food_trav_mode	{termLabel} {[termID]}	train travel [GENEPIO:0001060]																										
food_trav_vehic	{text}|{termLabel} {[termID]}	aircraft [ENVO:01001488]|car [ENVO:01000605]																										
food_treat_proc	{text}|{termLabel} {[termID]}	gluten removal process [FOODON:03460750]																										
freq_clean	[ Daily| Weekly| Monthly| Quarterly | Annually| other]																											
freq_clean	{text}	Daily																										
freq_cook	{integer}																											
fungicide_regm	{text};{float} {unit};{period};{interval};{period}																											
fungicide_regm	{text};{float} {unit};{Rn/start_time/end_time/duration}	bifonazole;1 mole per liter;R2/2018-05-11T14:30/2018-05-11T19:30/P1H30M																										
furniture	[cabinet|chair|desks]	chair																										
gaseous_environment	{text};{float} {unit};{period};{interval};{period}																											
gaseous_environment	{text};{float} {unit};{Rn/start_time/end_time/duration}	nitric oxide;0.5 micromole per liter;R2/2018-05-11T14:30/2018-05-11T19:30/P1H30M																										
gaseous_substances	{text};{float} {unit}																											
gastrointest_disord	{text}																											
gender_restroom	[all gender|female|gender neurtral|male|male and female|unisex]	male																										
genetic_mod	{PMID}|{DOI}|{URL}	aox1A transgenic																										
genetic_mod	{PMID}|{DOI}|{URL}|{text}	aox1A transgenic																										
geo_loc_name	"{term}: {term}, {text}"	"USA: Maryland, Bethesda"																										
gestation_state	{text}																											
glucosidase_act	{float} {unit}	5 mol per liter per hour																										
gravidity	{boolean};{timestamp}	yes;due date:2018-05-11																										
gravidity	{boolean};{timestamp}																											
gravity	{float} {unit};{Rn/start_time/end_time/duration}	12 g;R2/2018-05-11T14:30/2018-05-11T19:30/P1H30M																										
growth_facil	{text}|{termLabel} {[termID]}	Growth chamber [CO_715:0000189]																										
growth_habit	[erect|semi-erect|spreading|prostrate]	spreading																										
growth_hormone_regm	{text};{float} {unit};{Rn/start_time/end_time/duration}	abscisic acid;0.5 milligram per liter;R2/2018-05-11T14:30/2018-05-11T19:30/P1H30M																										
growth_medium	{text}	LB broth																										
gynecologic_disord	{text}																											
HACCP_term	{termLabel} {[termID]}	tetrodotoxic poisoning [FOODON:03530249]																										
hall_count	{integer}																											
handidness	[ambidexterity|left handedness|mixed-handedness|right handedness]	right handedness																										
hc_produced	[Oil|Gas-Condensate|Gas|Bitumen|Coalbed Methane|other]	Gas																										
hcr	[Oil Reservoir|Gas Reservoir|Oil Sand|Coalbed|Shale|Tight Oil Reservoir|Tight Gas Reservoir|other]	Oil Sand																										
hcr_fw_salinity	{float} {unit}																											
hcr_geol_age	[Archean|Cambrian|Carboniferous|Cenozoic|Cretaceous|Devonian|Jurassic|Mesozoic|Neogene|Ordovician|Paleogene|Paleozoic|Permian|Precambrian|Proterozoic|Silurian|Triassic|other]	Silurian																										
hcr_pressure	{float} - {float} {unit}																											
hcr_temp	{float} - {float} {unit}	150-295 degree Celsius																										
heat_cool_type	[radiant system|heat pump|forced air system|steam forced heat|wood stove]	heat pump																										
heat_deliv_loc	[north|south|east|west]	north																										
heat_sys_deliv_meth	[conductive|radiant]	radiant																										
heat_system_id	{integer}																											
heavy_metals	{text};{float} {unit}	mercury;0.09 micrograms per gram																										
heavy_metals_meth	{PMID}|{DOI}|{URL}																											
heavy_metals_meth	{PMID|DOI|URL}																											
height_carper_fiber	{float} {unit}																											
herbicide_regm	{text};{float} {unit};{period};{interval};{period}																											
herbicide_regm	{text};{float} {unit};{Rn/start_time/end_time/duration}	atrazine;10 milligram per liter;R2/2018-05-11T14:30/2018-05-11T19:30/P1H30M																										
horizon	[O horizon|A horizon|E horizon|B horizon|C horizon|R layer|Permafrost]																											
horizon_meth	{PMID}|{DOI}|{URL}																											
horizon_meth	{PMID|DOI|URL}																											
host_age	{float} {unit}	10 days																										
host_age	{float} {unit}	30 years																										
host_age	{float} {unit}																											
host_body_habitat	{text}	anterior end of a tapeworm																										
host_body_habitat	{text}	nasopharynx																										
host_body_mass_index	{float} {unit}	22 kilogram per square meter																										
host_body_product	{termLabel} {[termID]}	Portion of mucus [fma66938]																										
host_body_site	{termLabel} {[termID]}	Ectocervix [fma86484]																										
host_body_site	{termLabel} {[termID]}	Epithelium of tongue [fma284658]																										
host_body_site	{termLabel} {[termID]}	gill [UBERON:0002535]																										
host_body_site	{termLabel} {[termID]}	Lung parenchyma [fma27360]																										
host_body_site	{termLabel} {[termID]}	scolex [UBERON:0015119]																										
host_body_site	{termLabel} {[termID]}	Skin of palm of left hand [fma38303]																										
host_body_site	{termLabel} {[termID]}	Wall of gut [fma45653]																										
host_body_temp	{float} {unit}	15 degree Celsius																										
host_body_temp	{float} {unit}	36.5 degree Celsius																										
host_cellular_loc	[intracellular|extracellular|not determined]	extracellular																										
host_color	{text}																											
host_common_name	{text}	human																										
host_common_name	{text}	rice																										
host_common_name	{text}	trematode																										
host_common_name	{text}																											
host_dependence	[facultative|obligate]	obligate																										
host_diet	{text}	herbivore																										
host_diet	{text}	high-fat																										
host_disease_stat	{termLabel} {[termID]}	measles [DOID:8622]																										
host_disease_stat	{termLabel} {[termID]}|{text}	rabies [DOID:11260]																										
host_disease_stat	{text}|{termLabel} {[termID]}	downy mildew																										
host_dry_mass	{float} {unit}	500 gram																										
host_dry_mass	{float} {unit}																											
host_family_relation	{text};{text}	mother;ID298																										
host_family_relation	{text};{text}	offspring;Mussel25																										
host_family_relationship	{text};{text}	clone;P15																										
host_genotype	{text}	C57BL/6																										
host_genotype	{text}	ST1																										
host_genotype	{text}	Ts																										
host_genotype	{text}																											
host_growth_cond	{PMID}|{DOI}|{URL}|{text}	https://academic.oup.com/icesjms/article/68/2/349/617247																										
host_growth_cond	{PMID}|{DOI}|{URL}|{text}																											
host_height	{float} {unit}	0.1 meter																										
host_height	{float} {unit}	1 meter																										
host_height	{float} {unit}	1.75 meter																										
host_height	{float} {unit}																											
host_hiv_stat	{boolean};{boolean}	yes;yes																										
host_infra_specific_name	{text}																											
host_infra_specific_rank	{text}																											
host_last_meal	{text};{duration}	corn feed;P2H																										
host_last_meal	{text};{duration}	french fries;P5H30M																										
host_length	{float} {unit}	1 meter																										
host_length	{float} {unit}																											
host_life_stage	{text}	adult																										
host_life_stage	{text}	redia																										
host_life_stage	{text}																											
host_number	{float} m	3																										
host_occupation	{integer}	veterinary																										
host_of_host_coinf	{text}	Maritrema novaezealandense																										
host_of_host_disease	{termLabel} {[termID]}|{text}	rabies [DOID:11260]																										
host_of_host_env_loc	{termLabel} {[termID]}	small intestine[uberon:0002108]																										
host_of_host_env_med	{termLabel} {[termID]}	feces[uberon:0001988]																										
host_of_host_fam_rel	{text};{text}																											
host_of_host_geno	{text}																											
host_of_host_gravid	{boolean};{timestamp}																											
host_of_host_infname	{text}																											
host_of_host_infrank	{text}																											
host_of_host_name	{text}	snail																										
host_of_host_pheno	{term}																											
host_of_host_sub_id	{text}	H3																										
host_of_host_taxid	{integer}	145637																										
host_of_host_totmass	{float} {unit}																											
host_phenotype	{term}	soldier																										
host_phenotype	{term}																											
host_phenotype	{termLabel} {[termID]}	elongated [PATO:0001154]																										
host_phenotype	{termLabel} {[termID]}	Tinnitus [HP:0000360]																										
host_phenotype	{text};{termLabel} {[termID]}	seed pod; green [PATO:0000320]																										
host_pulse	{float} {unit}	65 beats per minute																										
host_sex	[female|hermaphrodite|male|neuter]																											
host_sex	"[female|hermaphrodite|non-binary|male|transgender|transgender (female to male)|transgender (male to female)
|undeclared]"	non-binary																										
host_shape	{text}	round																										
host_shape	{text}																											
host_spec_range	{integer}																											
host_specificity	[family-specific|generalist||genus-specific|species-specific]	species-specific																										
host_subject_id	{text}	MPI123																										
host_subject_id	{text}	P14																										
host_subspecf_genlin	{rank name}:{text}	"serovar:Newport, variety:glabrum, cultivar: Red Delicious"																										
host_substrate	{text}	rock																										
host_substrate	{text}																											
host_symbiont	{text}	flukeworms																										
host_symbiont	{text}	Paragordius varius																										
host_taxid	{integer}	9606																										
host_taxid	{integer}	395013																										
host_taxid	{NCBI taxid}	4530																										
host_taxid	{NCBI taxid}	7955																										
host_tot_mass	{float} {unit}	2500 gram																										
host_tot_mass	{float} {unit}	65 kilogram																										
host_tot_mass	{float} {unit}																											
host_wet_mass	{float} {unit}	1500 gram																										
hrt	{timestamp}	5/11/18																										
humidity	{float} {unit}	25 gram per cubic meter																										
humidity	{float} {unit}	30% relative humidity																										
humidity_regm	{float} {unit};{Rn/start_time/end_time/duration}	25 gram per cubic meter;R2/2018-05-11T14:30/2018-05-11T19:30/P1H30M																										
hygienic_area	{termLabel} {[termID]}	Low Hygiene Area																										
hysterectomy	{boolean}	no																										
IFSAC_category	{text}	Plants:Produce:Vegetables:Herbs:Dried Herbs																										
ihmc_medication_code	{integer}	810																										
indoor_space	[bedroom|office|bathroom|foyer|kitchen|locker room|hallway|elevator]	foyer																										
indoor_surf	[cabinet|ceiling|counter top|door|shelving|vent cover|window|wall]	wall																										
indust_eff_percent	{float} {unit}																											
inorg_particles	{text};{float} {unit}																											
inside_lux	{float} {unit}																											
int_wall_cond	[new|visible wear|needs repair|damaged|rupture]	damaged																										
intended_consumer	{integer}|{termLabel} {[termID]}	9606 o rsenior as food consumer [FOODON:03510254]																										
isol_growth_condt	{PMID|DOI|URL}																											
iw_bt_date_well	{timestamp}	5/11/18																										
iwf	{float} {unit}																											
kidney_disord	{text}																											
last_clean	{timestamp}	2018-05-11:T14:30Z																										
lat_lon	{float} {float}	50.586825 6.408977																										
lib_layout	[paired|single|vector|other]	paired																										
lib_reads_seqd	{integer}																											
lib_screen	{text}	"enriched, screened, normalized"																										
lib_size	{integer}																											
lib_vector	{text}																											
library_prep_kit	{text}	Illumina DNA Prep																										
library_prep_kit	{text}	"llumina DNA Prep, (M) Tagmentation"																										
light_intensity	{float} {unit}	0.3 lux																										
light_regm	{text};{float} {unit};{float} {unit}	incandescant light;10 lux;450 nanometer																										
light_type	[natural light|electric light|desk lamp|flourescent lights|natural light|none]	desk lamp																										
link_addit_analys	{PMID}|{DOI}|{URL}																											
link_class_info	{PMID}|{DOI}|{URL}																											
link_class_info	{PMID|DOI|URL}																											
link_climate_info	{PMID}|{DOI}|{URL}																											
link_climate_info	{PMID|DOI|URL}																											
lithology	[Basement|Chalk|Chert|Coal|Conglomerate|Diatomite|Dolomite|Limestone|Sandstone|Shale|Siltstone|Volcanic|other]	Volcanic																										
liver_disord	{text}																											
local_class	{text}																											
local_class_meth	{PMID}|{DOI}|{URL}																											
local_class_meth	{PMID|DOI|URL}																											
lot_number	"{integer}, {text}"	"1239ABC01A, split Cornish hens"																										
magnesium	{float} {unit}	52.8 micromole per kilogram																										
maternal_health_stat	{text}																											
max_occup	{integer}																											
mean_frict_vel	{float} {unit}	0.5 meter per second																										
mean_peak_frict_vel	{float} {unit}	1 meter per second																										
mech_struc	[subway|coach|carriage|elevator|escalator|boat|train|car|bus]	elevator																										
mechanical_damage	{text};{text}	pruning;bark																										
medic_hist_perform	{boolean}	TRUE																										
menarche	{timestamp}	5/11/18																										
menopause	{timestamp}	5/11/18																										
methane	{float} {unit}	0.15 micromole per liter																										
methane	{float} {unit}	1800 parts per billion																										
micro_biomass_meth	{PMID}|{DOI}|{URL}																											
microb_cult_med	{text}|{termLabel} {[termID]}	brain heart infusion agar [MICRO:0000566]																										
microb_start	{term label} {[termID]}|{text}	starter cultures [FOODON:03544454]																										
microb_start_count	{text};{float} {unit};[ATP|MPN|qPCR|spread plate|other]	total prokaryotes;3.5e9 colony forming units per milliliter;spread plate																										
microb_start_inoc	{float} {unit}	100 milligrams																										
microb_start_prep	{text}	"liquid starter culture, propagated 3 cycles in milk prior to inoculation"																										
microb_start_source	{text}	"backslopped, GetCulture"																										
microb_start_taxID	{termLabel} {[termID]}|{integer}	Lactobacillus rhamnosus [NCIT:C123495]																										
microbial_biomass	{float} {unit}																											
microbial_biomass_meth	{PMID|DOI|URL}																											
mid	{dna}																											
mineral_nutr_regm	{text};{float} {unit};{Rn/start_time/end_time/duration}	potassium;15 gram;R2/2018-05-11T14:30/2018-05-11T19:30/P1H30M																										
misc_param	{text};{float} {unit}	Bicarbonate ion concentration;2075 micromole per kilogram																										
misc_param	{text};{float} {unit}																											
mode_transmission	[horizontal:castrator|horizontal:directly transmitted|horizontal:micropredator|horizontal:parasitoid|horizontal:trophically transmitted|horizontal:vector transmitted|vertical]	horizontal:castrator																										
n_alkanes	{text};{float} {unit}	n-hexadecane;100 milligram per liter																										
nitrate	{float} {unit}	65 micromole per liter																										
nitrite	{float} {unit}	0.5 micromole per liter																										
nitro	{float} {unit}	4.2 micromole per liter																										
non_min_nutr_regm	{text};{float} {unit};{Rn/start_time/end_time/duration}	carbon dioxide;10 mole per liter;R2/2018-05-11T14:30/2018-05-11T19:30/P1H30M																										
non_mineral_nutr_regm	{text};{float} {unit};{period};{interval};{period}																											
nose_throat_disord	{text}																											
nucl_acid_amp	{PMID|DOI|URL}																											
nucl_acid_ext	{PMID}|{DOI}|{URL}	https://mobio.com/media/wysiwyg/pdfs/protocols/12888.pdf																										
nucl_acid_ext	{PMID|DOI|URL}																											
nucl_acid_ext_kit	{text}	Qiagen PowerSoil Kit																										
num_samp_collect	{float} {unit}	116 samples																										
number_pets	{integer}																											
number_plants	{integer}																											
number_resident	{integer}																											
occup_density_samp	{float}																											
occup_document	[automated count|estimate|manual count|videos]	estimate																										
occup_samp	{integer}	10																										
org_carb	{float} {unit}	1.5 microgram per liter																										
org_count_qpcr_info	{text};FWD:{dna};REV:{dna};initial denaturation:degrees_minutes;denaturation:degrees_minutes;annealing:degrees_minutes;elongation:degrees_minutes;final elongation:degrees_minutes; total cycles																											
org_matter	{float} {unit}	1.75 milligram per cubic meter																										
org_nitro	{float} {unit}	4 micromole per liter																										
org_particles	{text};{float} {unit}																											
organism_count	{text};{float} {unit}	total prokaryotes;3.5e7 cells per milliliter;qPCR																										
organism_count	{text};{float} {unit};[ATP|MPN|qPCR|other]	total prokaryotes;3.5e7 colony forming units per milliliter;qPCR																										
organism_count	{text};{float} {unit};[qPCR|ATP|MPN|other]	total prokaryotes;3.5e7 cells per milliliter;qPCR																										
owc_tvdss	{float} {unit}																											
oxy_stat_samp	[aerobic|anaerobic]	aerobic																										
oxy_stat_samp	[aerobic|anaerobic]																											
oxy_stat_samp	[aerobic|anaerobic|other]	aerobic																										
oxygen	{float} {unit}	600 parts per million																										
part_org_carb	{float} {unit}	1.92 micromole per liter																										
part_org_nitro	{float} {unit}	0.3 micromole per liter																										
part_plant_animal	{text}|{termLabel} {[termID]}	chuck [FOODON:03530021]																										
particle_class	{text};{float} {unit}																											
pathogenicity	{term}	"human, animal, plant, fungi, bacteria"																										
pcr_cond	initial denaturation:degrees_minutes; annealing:degrees_minutes; elongation: degrees_minutes; final elongation:degrees_minutes; total cycles																											
pcr_primers		FWD: forward primer sequence REV:reverse primer sequence																										
permeability	{integer} - {integer} {unit}																											
perturbation	{text};{interval}																											
perturbation	{text};{Rn/start_time/end_time/duration}	antibiotic addition;R2/2018-05-11T14:30Z/2018-05-11T19:30Z/P1H30M																										
perturbation	{text};{Rn/start_time/end_time/duration}																											
pesticide_regm	{text};{float} {unit};{period};{interval};{period}																											
pesticide_regm	{text};{float} {unit};{Rn/start_time/end_time/duration}	pyrethrum;0.6 milligram per liter;R2/2018-05-11T14:30/2018-05-11T19:30/P1H30M																										
pet_farm_animal	{boolean};{text}	yes; 5 cats																										
petroleum_hydrocarb	{float} {unit}	0.05 micromole per liter																										
ph	{float}	7.2																										
ph_meth	{PMID}|{DOI}|{URL}	https://www.epa.gov/sites/production/files/2015-12/documents/9040c.pdf																										
ph_meth	{PMID}|{DOI}|{URL}																											
ph_meth	{PMID|DOI|URL}																											
ph_regm	{float};{period};{interval};{period}																											
ph_regm	{float};{Rn/start_time/end_time/duration}	7.6;R2/2018-05-11:T14:30/2018-05-11T19:30/P1H30M																										
phaeopigments	{text};{float} {unit}	2.5 milligram per cubic meter																										
phosphate	{float} {unit}	0.7 micromole per liter																										
phosplipid_fatt_acid	{text};{float} {unit}	2.98 milligram per liter																										
photon_flux	{float} {unit}	3.926 micromole photons per second per square meter																										
photosynt_activ	{float} {unit}	_mol CO2 m-2 s-1																										
photosynt_activ_meth	{PMID}|{DOI}|{URL}|{text}																											
plant_growth_med	{termLabel} {[termID]} or [husk|other artificial liquid medium|other artificial solid medium|peat moss|perlite|pumice|sand|soil|vermiculite|water]	hydroponic plant culture media [EO:0007067]																										
plant_growth_med	{termLabel} {[termID]} or [husk|other artificial liquid medium|other artificial solid medium|peat moss|perlite|pumice|sand|soil|vermiculite|water]	soil																										
plant_part_maturity	{term label}{term ID}	ripe or mature [FOODON:03530052]																										
plant_product	{text}	xylem sap [PO:0025539]																										
plant_product	{text}																											
plant_reprod_crop	[plant cutting|pregerminated seed|ratoon|seed|seedling|whole mature plant]	seedling																										
plant_sex	[Androdioecious|Androecious|Androgynous|Androgynomonoecious|Andromonoecious|Bisexual|Dichogamous|Diclinous|Dioecious|Gynodioecious|Gynoecious|Gynomonoecious|Hermaphroditic|Imperfect|Monoclinous|Monoecious|Perfect|Polygamodioecious|Polygamomonoecious|Polygamous|Protandrous|Protogynous|Subandroecious|Subdioecious|Subgynoecious|Synoecious|Trimonoecious|Trioecious|Unisexual]	Hermaphroditic																										
plant_struc	{termLabel} {[termID]}	epidermis [PO:0005679]																										
plant_water_method	{termLabel} {[termID]}	drip irrigation process [AGRO:00000056]																										
pollutants	{text};{float} {unit}	lead;0.15 microgram per cubic meter																										
pool_dna_extracts	"{boolean},{integer}"	"yes, 5"																										
pool_dna_extracts	{boolean};{float} {unit}																											
pool_dna_extracts	{boolean};{integer}	yes;5																										
porosity	{float} - {float} {unit}																											
potassium	{float} {unit}	463 milligram per liter																										
pour_point	{float} {unit}																											
pre_treatment	{text}																											
pregnancy	{timestamp}	5/11/18																										
pres_animal_insect	[cat|dog|rodent|snake|other];{integer}	cat;5																										
pressure	{float} {unit}	50 atmosphere																										
prev_land_use_meth	{PMID}|{DOI}|{URL}																											
previous_land_use	{text};{timestamp}	fallow; 2018-05-11:T14:30Z																										
previous_land_use	{text};{timestamp}																											
previous_land_use_meth	{PMID|DOI|URL}																											
primary_prod	{float} {unit}	100 milligram per cubic meter per day																										
primary_treatment	{text}																											
prod_label_claims	{text}	free range																										
prod_rate	{float} {unit}																											
prod_start_date	{timestamp}	5/11/18																										
profile_position	[summit|shoulder|backslope|footslope|toeslope]	summit																										
profile_position	[summit|shoulder|backslope|footslope|toeslope]																											
project_name	{text}	Forest soil metagenome																										
pulmonary_disord	{text}																											
quad_pos	[North side|West side|South side|East side]	West side																										
radiation_regm	{text};{float} {unit};{Rn/start_time/end_time/duration}	gamma radiation;60 gray;R2/2018-05-11T14:30/2018-05-11T19:30/P1H30M																										
rainfall_regm	{float} {unit};{Rn/start_time/end_time/duration}	15 millimeter;R2/2018-05-11T14:30/2018-05-11T19:30/P1H30M																										
reactor_type	{text}																											
redox_potential	{float} {unit}	300 millivolt																										
rel_air_humidity	{float} {unit}	80%																										
rel_humidity_out	{float} {unit}	12 per kilogram of air																										
rel_location	{text}	furrow																										
rel_location		furrow																										
rel_samp_loc	[edge of car|center of car|under a seat]	center of car																										
repository_name	{text}	FDA CFSAN Microbiology Laboratories																										
reservoir	{text}																											
resins_pc	{text};{float} {unit}																											
room_air_exch_rate	{float} {unit}																											
room_architec_elem	{text}																											
room_condt	[new|visible wear|needs repair|damaged|rupture|visible signs of mold/mildew]	new																										
room_connected	[attic|bathroom|closet|conference room|elevator|examining room|hallway|kitchen|mail room|office|stairwell]	office																										
room_count	{integer}																											
room_dim	{integer} {unit} x {integer} {unit} x {integer} {unit}	4 meter x 4 meter x 4 meter																										
room_dim	{integer} {unit} x {integer} {unit} x {integer} {unit}																											
room_door_dist	{integer} {unit}																											
room_door_share	{text};{integer}																											
room_hallway	{text};{integer}																											
room_loc	[corner room|interior room|exterior wall]	interior room																										
room_moist_dam_hist	{integer}																											
room_net_area	{integer} {unit}																											
room_occup	{integer}																											
room_samp_pos	[north corner|south corner|west corner|east corner|northeast corner|northwest corner|southeast corner|southwest corner|center]	south corner																										
room_type	"[attic|bathroom|closet|conference room|elevator|examining room|hallway|kitchen|mail room|private office|open office|stairwell|,restroom|lobby|vestibule|mechanical or electrical room|data center|laboratory_wet|laboratory_dry|gymnasium|natatorium|auditorium|lockers|cafe|warehouse]"	bathroom																										
room_vol	{integer} {unit}																											
room_wall_share	{text};{integer}																											
room_window_count	{integer}																											
root_cond	{PMID}|{DOI}|{URL}|{text}	http://himedialabs.com/TD/PT158.pdf																										
root_med_carbon	{text};{float} {unit}	sucrose																										
root_med_macronutr	{text};{float} {unit}	KH2PO4;170 milligram per liter																										
root_med_micronutr	{text};{float} {unit}	H3BO3;6.2 milligram per liter																										
root_med_ph	{float}	7.5																										
root_med_regl	{text};{float} {unit}	abscisic acid;0.75 milligram per liter																										
root_med_solid	{text}	agar																										
root_med_suppl	{text};{float} {unit}	nicotinic acid;0.5 milligram per liter																										
route_transmission	[environmental:faecal-oral|transplacental|vector-borne:vector penetration]																											
salinity	{float} {unit}	25 practical salinity unit																										
salinity_meth	{PMID}|{DOI}|{URL}	PMID: 22895776																										
salinity_meth	{PMID}|{DOI}|{URL}																											
salt_regm	{text};{float} {unit};{period};{interval};{period}																											
salt_regm	{text};{float} {unit};{Rn/start_time/end_time/duration}	NaCl;5 gram per liter;R2/2018-05-11T14:30/2018-05-11T19:30/P1H30M																										
samp_capt_status	[active surveillance in response to an outbreak|active surveillance not initiated by an outbreak|farm sample|market sample|other]	farm sample																										
samp_collect_device	{termLabel} {[termID]}|{text}	"swab, biopsy, niskin bottle, push core, drag swab [GENEPIO:0002713]"																										
samp_collect_device	{text}	"biopsy, niskin bottle, push core"																										
samp_collect_method	{PMID}|{DOI}|{URL}|{text}	environmental swab sampling																										
samp_collect_point	[well|test well|drilling rig|wellhead|separator|storage tank|other]	well																										
samp_dis_stage	[dissemination|growth and reproduction|infection|inoculation|penetration|other]	infection																										
samp_floor	[1st floor|2nd floor|{integer} floor|basement|lobby]	4th floor																										
samp_loc_condition	[damaged|new|rupture|visible signs of mold-mildew|visible weariness repair]	new																										
samp_loc_corr_rate	{float} - {float} {unit}																											
samp_mat_process	{text|term}	"filtering of seawater, storing samples in ethanol"																										
samp_md	{float} {unit};[GL|DF|RT|KB|MSL|other]	1534 meter;MSL																										
samp_name	{text}	ISDsoil1																										
samp_pooling	{text}	5uL of extracted genomic DNA from 5 leaves were pooled																										
samp_pooling																												
samp_preserv	{text};{float} {unit}																											
samp_purpose	[active surveillance in response to an outbreak|active surveillance not initiated by an outbreak|clinical trial|cluster investigation|environmental assessment|farm sample|field trial|for cause|industry internal investigation|market sample|passive surveillance|population based studies|research|research and development] or {text}	field trial																										
samp_rep_biol	{float} {unit}	6 replicates																										
samp_rep_tech	{float} {unit}	10 replicates																										
samp_room_id	{integer}																											
samp_salinity	{float} {unit}	1 milligram per liter																										
samp_size	{float} {unit}	5 liters																										
samp_size	{float} {unit}																											
samp_sort_meth	{text}																											
samp_source_mat_cat	{termLabel} {[termID]}	environmental (swab or sampling) [GENEPIO:0001732]																										
samp_source_mat_cat	{termLabel} {[termID]}	environmental swab specimen [OBI:0002613]																										
samp_stor_device	{text}|{termLabel} {[termID]}	Whirl Pak sampling bag [GENEPIO:0002122]																										
samp_stor_dur	{duration}	P1Y6M																										
samp_stor_loc	{text}	freezer 5																										
samp_stor_media	{text}|{termLabel} {[termID]}	peptone water medium [MICRO:0000548]																										
samp_stor_temp	{float} {unit}	-80 degree Celsius																										
samp_store_dur	{duration}	P1Y6M																										
samp_store_dur	{interval}																											
samp_store_loc	{text}	Freezer no:5																										
samp_store_loc	{text}																											
samp_store_sol	{text}	5% ethanol																										
samp_store_temp	{float} {unit}	-80 degree Celsius																										
samp_store_temp	{float} {unit}																											
samp_subtype	[oil phase|water phase|biofilm|not applicable|other]	biofilm																										
samp_surf_moisture	[intermittent moisture|not present|submerged]	submerged																										
samp_time_out	{float}																											
samp_transport_cond	{float} {unit};{float} {unit}	5 days;-20 degree Celsius																										
samp_transport_cont	[bottle|cooler|glass vial|plastic vial||vendor supplied container]	cooler																										
samp_transport_dur	{float} {unit}	P10D																										
samp_transport_temp	{float} {unit} {text}	4 degree Celsius																										
samp_tvdss	{float}-{float} {unit}																											
samp_type	{termLabel} {[termID]}	built environment sample [GENEPIO:0001248]																										
samp_vol_we_dna_ext	{float} {unit}	1500 milliliter																										
samp_vol_we_dna_ext	{float} {unit}																											
samp_weather	[clear sky|cloudy|foggy|hail|rain|snow|sleet|sunny|windy]	foggy																										
samp_well_name	{text}																											
sample_collec_method	{PMID}|{DOI}|{URL}|{text}	environmental swab sampling																										
sample_name	{text}	ISDsoil1																										
saturates_pc	{text};{float} {unit}																											
season	{termLabel} {[termID]}	autumn [NCIT:C94733]																										
season_environment	{text};{period};{interval};{period}																											
season_environment	{text};{Rn/start_time/end_time/duration}	rainy;R2/2018-05-11T14:30/2018-05-11T19:30/P1H30M																										
season_humidity	{float} {unit}	25%																										
season_precpt	{float} {unit}	75 millimeters																										
season_precpt	{float} {unit}																											
season_temp	{float} {unit}	18 degree Celsius																										
season_use	[Spring|Summer|Fall|Winter]	Winter																										
secondary_treatment	{text}																											
sediment_type	[biogenous|cosmogenous|hydrogenous|lithogenous]	biogenous																										
seq_meth	{termLabel} {[termID]}|{text}	454 Genome Sequencer FLX [OBI:0000702]																										
seq_quality_check	[none|manually edited]																											
sequencing_kit	{text}	NextSeq 500/550 High Output Kit v2.5 (75 Cycles)																										
sequencing_location	{text}	University of Maryland Genomics Resource Center																										
serovar_or_serotype	{termLabel} {[termID]}|{integer}	Escherichia coli strain O157:H7 [NCIT:C86883]																										
sewage_type	{text}																											
sexual_act	{text}																											
shad_dev_water_mold	[presence of mold visible|no presence of mold visible]	no presence of mold visible																										
shading_device_cond	[damaged|needs repair|new|rupture|visible wear]	new																										
shading_device_loc	[exterior|interior]	exterior																										
shading_device_mat	{text}																											
shading_device_type	[bahama shutters|exterior roll blind|gambrel awning|hood awning|porchroller awning|sarasota shutters|slatted aluminum|solid aluminum awning|sun screen|tree|trellis|venetian awning]	slatted aluminum awning																										
sieving	{{text}|{float} {unit}};{float} {unit}																											
silicate	{float} {unit}	0.05 micromole per liter																										
size_frac_low	{float} {unit}	0.2 micrometer																										
size_frac_up	{float} {unit}	20 micrometer																										
slope_aspect	{float} {unit}																											
slope_gradient	{float} {unit}																											
sludge_retent_time	{float} {unit}																											
smoker	{boolean}	yes																										
sodium	{float} {unit}	10.5 milligram per liter																										
soil_conductivity	{float} {unit}	10 milliSiemens per centimeter																										
soil_conductivity																												
soil_cover	{termLabel} {[termID]}	bare soil [ENVO01001616]																										
soil_cover																												
soil_depth	{float} {unit}	5 cm																										
soil_horizon	[O horizon|A horizon|E horizon|B horizon|C horizon|R layer|Permafrost]	A horizon																										
soil_horizon	enumeration	[O horizon|A horizon|E horizon|B horizon|C horizon|R layer|Permafrost]																										
soil_pH	{float}	7.2																										
soil_pH																												
soil_porosity	{percentage}	20%																										
soil_temp	{float}{unit}	25 degrees Celsius																										
soil_text_measure	{float} {unit}																											
soil_texture_class	[clay|clay loam|loam|loamy sand|sand|sandy clay|sandy clay loam|sandy loam|silt|silty clay|silty clay loam|silt loam]	silty clay loam																										
soil_texture_meth	{PMID}|{DOI}|{URL}	https://uwlab.soils.wisc.edu/wp-content/uploads/sites/17/2015/09/particle_size.pdf (hydrometer method)																										
soil_texture_meth	{PMID}|{DOI}|{URL}																											
soil_type	{termLabel} {[termID]}	plinthosol [ENVO:00002250]																										
soil_type	"{termLabel} {[termID]}
"	plinthosol [ENVO:00002250]																										
soil_type	{text}																											
soil_type_meth	{PMID}|{DOI}|{URL}	Frederick series; Weikert series																										
soil_type_meth	{PMID}|{DOI}|{URL}																											
soil_type_meth	{PMID|DOI|URL}																											
solar_irradiance	{float} {unit}	1.36 kilowatts per square meter per day																										
soluble_inorg_mat	{text};{float} {unit}																											
soluble_org_mat	{text};{float} {unit}																											
soluble_react_phosp	{float} {unit}	0.1 milligram per liter																										
sop	{PMID|DOI|URL}																											
source_mat_id	{text}	MPI012345																										
source_mat_id	{text}																											
space_typ_state	[typically occupied|typically unoccupied]	typically occupied																										
spec_intended_cons	{termLabel} {[termID]}	senior as food consumer [FOODON:03510254]																										
special_diet	[low carb|reduced calorie|vegetarian|other(to be specified)]	other:vegan																										
specific	[operation|as built|construction|bid|design|photos]	construction																										
specific_host	{text}|{NCBI taxid}	Homo sapiens and/or 9606																										
specific_humidity	{float} {unit}	15 per kilogram of air																										
spikein_AMR	{float} {unit};{termLabel} {[termID]}	wild type [ARO:3004432]																										
spikein_antibiotic	{text} {integer}	Tetracycline at 5 mg/ml																										
spikein_count	{text};{float} {unit};[ATP|MPN|qPCR|other]	total prokaryotes;3.5e7 colony forming units per milliliter;qPCR																										
spikein_growth_med	{text}|{termLabel} {[termID]}	LB broth [MCO:0000036]																										
spikein_metal	{text} {integer}	Cd at 20 ppm																										
spikein_org	{termLabel} {[termID]}|{integer}	Listeria monocytogenes [NCIT:C86502]|28901																										
spikein_serovar	{termLabel} {[termID]}|{integer}	Escherichia coli strain O157:H7 [NCIT:C86883]|83334																										
spikein_strain	{termLabel} {[termID]}|{integer}	169963																										
sr_dep_env	[Lacustine|Fluvioldeltaic|Fluviomarine|Marine|other]	Marine																										
sr_geol_age	[Archean|Cambrian|Carboniferous|Cenozoic|Cretaceous|Devonian|Jurassic|Mesozoic|Neogene|Ordovician|Paleogene|Paleozoic|Permian|Precambrian|Proterozoic|Silurian|Triassic|other]	Silurian																										
sr_kerog_type	[Type I|Type II|Type III|Type IV|other]	Type IV																										
sr_lithology	[Clastic|Carbonate|Coal|Biosilicieous|other]	Coal																										
standing_water_regm	{text};{period};{interval};{period}																											
standing_water_regm	{text};{Rn/start_time/end_time/duration}	standing water;R2/2018-05-11T14:30/2018-05-11T19:30/P1H30M																										
ster_meth_samp_room	{text}|{termLabel} {[termID]}	ultraviolet radiation [ENVO:21001216]|infrared radiation [ENVO:21001214]																										
store_cond	{text};{duration}	-20 degree Celsius freezer;P2Y10D																										
store_cond	{text};{period}																											
study_complt_stat	{boolean};[adverse event|non-compliance|lost to follow up|other-specify]	no;non-compliance																										
study_design	{text}|{termLabel} {[termID]}	in vitro design [OBI:0001285]																										
study_inc_dur	{float} {unit}	P24H																										
study_inc_temp	{float} {unit}	37 degree Celsius																										
study_timecourse	{float} {unit}	2 days post inoculation																										
study_tmnt	{text}|{termLabel} {[termID]}	"Factor A|spike-in|levels high, medium, low"																										
subspecf_gen_lin	{rank name}:{text}	serovar:Newport																										
substructure_type	[crawlspace|slab on grade|basement]	basement																										
sulfate	{float} {unit}	5 micromole per liter																										
sulfate_fw	{float} {unit}																											
sulfide	{float} {unit}	2 micromole per liter																										
surf_air_cont	[dust|organic matter|particulate matter|volatile organic compounds|biological contaminants|radon|nutrients|biocides]	radon																										
surf_humidity	{float} {unit}	10%																										
surf_material	[adobe|carpet|cinder blocks|concrete|hay bales|glass|metal|paint|plastic|stainless steel|stone|stucco|tile|vinyl|wood]	wood																										
surf_moisture	{float} {unit}	0.01 gram per square meter																										
surf_moisture_ph	{float}	7																										
surf_temp	{float} {unit}	15 degree Celsius																										
suspend_part_matter	{float} {unit}	0.5 milligram per liter																										
suspend_solids	{text};{float} {unit}																											
sym_life_cycle_type	[complex life cycle | simple life cycle]	complex life cycle																										
symbiont_host_role	[accidental|dead-end|definitive|intermediate|paratenic|reservoir|single host]	intermediate																										
tan	{float} {unit}																											
target_gene	{text}	"16S rRNA, 18S rRNA, nif, amoA, rpo"																										
target_subfragment	{text}	"V6, V9, ITS"																										
temp	{float} {unit}	25 degree Celsius																										
temp	{float} {unit}																											
temp_out	{float} {unit}	5 degree Celsius																										
tertiary_treatment	{text}																											
texture	{float} {unit}																											
texture_meth	{PMID}|{DOI}|{URL}																											
tidal_stage	[low tide|ebb tide|flood tide|high tide]	high tide																										
tillage	[drill|cutting disc|ridge till|strip tillage|zonal tillage|chisel|tined|mouldboard|disc plough]	chisel																										
tillage	[drill|cutting disc|ridge till|strip tillage|zonal tillage|chisel|tined|mouldboard|disc plough]																											
time_last_toothbrush	{duration}	P2H45M																										
time_since_last_wash	{duration}	P1D																										
timepoint	{float}	P24H																										
tiss_cult_growth_med	{PMID}|{DOI}|{URL}|{text}	https://link.springer.com/content/pdf/10.1007/BF02796489.pdf																										
toluene	{float} {unit}																											
tot_car	{float} {unit}																											
tot_carb	{float} {unit}																											
tot_depth_water_col	{float} {unit}	500 meter																										
tot_diss_nitro	{float} {unit}	40 microgram per liter																										
tot_inorg_nitro	{float} {unit}	40 microgram per liter																										
tot_iron	{float} {unit}																											
tot_n_meth	{PMID|DOI|URL}																											
tot_nitro	{float} {unit}	50 micromole per liter																										
tot_nitro	{float} {unit}																											
tot_nitro_cont_meth	{PMID}|{DOI}|{URL}	https://currentprotocols.onlinelibrary.wiley.com/doi/abs/10.1002/0471142913.fab0102s00																										
tot_nitro_cont_meth	{PMID}|{DOI}|{URL}																											
tot_nitro_content	{float} {unit}	35 milligrams Nitrogen per kilogram of soil																										
tot_nitro_content	{float} {unit}																											
tot_org_c_meth	{PMID}|{DOI}|{URL}	https://www.epa.gov/sites/production/files/2015-12/documents/9060a.pdf																										
tot_org_c_meth	{PMID}|{DOI}|{URL}																											
tot_org_c_meth	{PMID|DOI|URL}																											
tot_org_carb	{float} {unit}																											
tot_org_carb	{percentage}	2%																										
tot_part_carb	{float} {unit}	35 micromole per liter																										
tot_phos	{float} {unit}																											
tot_phosp	{float} {unit}	0.03 milligram per liter																										
tot_phosphate	{float} {unit}																											
tot_sulfur	{float} {unit}																											
train_line	[red|green|orange]	red																										
train_stat_loc	[south station above ground|south station underground|south station amtrak|forest hills|riverside]	forest hills																										
train_stop_loc	[end|mid|downtown]	end																										
travel_out_six_month	{text}																											
trophic_level	[autotroph| carboxydotroph| chemoautotroph| chemoheterotroph| chemolithoautotroph| chemolithotroph| chemoorganoheterotroph| chemoorganotroph| chemosynthetic| chemotroph| copiotroph| diazotroph| facultative| autotroph| heterotroph| lithoautotroph| lithoheterotroph| lithotroph| methanotroph| methylotroph| mixotroph| obligate| chemoautolithotroph| oligotroph| organoheterotroph| organotroph| photoautotroph| photoheterotroph| photolithoautotroph| photolithotroph| photosynthetic| phototroph]																											
turbidity	{float} {unit}	0.3 nephelometric turbidity units																										
tvdss_of_hcr_press	{float} {unit}																											
tvdss_of_hcr_temp	{float} {unit}																											
twin_sibling	{boolean}	yes																										
typ_occup_density	{float}	25																										
type_of_symbiosis	[commensalistic|mutualistic|parasitic]	parasitic																										
urine_collect_meth	[clean catch|catheter]	catheter																										
url	{URL}																											
urogenit_disord	{text}																											
urogenit_tract_disor	{text}																											
ventilation_rate	{float} {unit}	750 cubic meter per minute																										
ventilation_type	{text}	Operable windows																										
vfa	{float} {unit}																											
vfa_fw	{float} {unit}																											
vis_media	"[photos|videos|commonly of the building|site context (adjacent buildings, vegetation, terrain, streets)|interiors|equipment|3D scans]"	3D scans																										
viscosity	{float} {unit};{float} {unit}																											
volatile_org_comp	{text};{float} {unit}	formaldehyde;500 nanogram per liter																										
wall_area	{float} {unit}																											
wall_const_type	[frame construction|joisted masonry|light noncombustible|masonry noncombustible|modified fire resistive|fire resistive]	fire resistive																										
wall_finish_mat	[plaster|gypsum plaster|veneer plaster|gypsum board|tile|terrazzo|stone facing|acoustical treatment|wood|metal|masonry]	wood																										
wall_height	{float} {unit}																											
wall_loc	[north|south|east|west]	north																										
wall_surf_treatment	[painted|wall paper|no treatment|paneling|stucco|fabric]	paneling																										
wall_texture	[crows feet|crows-foot stomp||double skip|hawk and trowel|knockdown|popcorn|orange peel|rosebud stomp|Santa-Fe texture|skip trowel|smooth|stomp knockdown|swirl]	popcorn																										
wall_thermal_mass	{float} {unit}																											
wall_water_mold	[presence of mold visible|no presence of mold visible]	no presence of mold visible																										
wastewater_type	{text}																											
water_cont_soil_meth	{PMID}|{DOI}|{URL}																											
water_content	{float}																											
water_content	{float} {unit}																											
water_current	{float} {unit}	10 cubic meter per second																										
water_cut	{float} {unit}																											
water_feat_size	{float} {unit}																											
water_feat_type	[fountain|pool|standing feature|stream|waterfall]	stream																										
water_frequency	{float}{unit}	2 per day																										
water_pH	{float}	7.2																										
water_prod_rate	{float} {unit}																											
water_source_adjac	{text}	feedlot [ENVO:01000627]																										
water_source_shared	"[multiple users, agricutural|multiple users, other|no sharing]"	no sharing																										
water_temp_regm	{float} {unit};{period};{interval};{period}																											
water_temp_regm	{float} {unit};{Rn/start_time/end_time/duration}	15 degree Celsius;R2/2018-05-11T14:30/2018-05-11T19:30/P1H30M																										
watering_regm	{float} {unit};{period};{interval};{period}																											
watering_regm	{float} {unit};{Rn/start_time/end_time/duration}	1 liter;R2/2018-05-11T14:30/2018-05-11T19:30/P1H30M																										
weekday	[Monday|Tuesday|Wednesday|Thursday|Friday|Saturday|Sunday]	Sunday																										
weight_loss_3_month	{boolean};{float} {unit}	yes;5 kilogram																										
win	{text}																											
wind_direction	{text}	0 degrees; Northwest																										
wind_direction	{text}	Northwest																										
wind_speed	{float} {unit}	1.6 kilometers per hour																										
wind_speed	{float} {unit}	21 kilometer per hour																										
window_cond	[damaged|needs repair|new|rupture|visible wear]	rupture																										
window_cover	[blinds|curtains|none]	curtains																										
window_horiz_pos	[left|middle|right]	middle																										
window_loc	[north|south|east|west]	west																										
window_mat	[clad|fiberglass|metal|vinyl|wood]	wood																										
window_open_freq	{integer}																											
window_size	{float} {unit} x {float} {unit}																											
window_status	[closed|open]	open																										
window_type	[single-hung sash window|horizontal sash window|fixed window]	fixed window																										
window_vert_pos	[bottom|middle|top|low|middle|high]	middle																										
window_water_mold	[presence of mold visible|no presence of mold visible]	no presence of mold visible																										
xylene	{float} {unit}																											
																												
																												
																												
																												
																												
																												
																												
																												
																												
																												
																												
																												
																												
																												
																												
																												
																												
																												
																												
																												
																												
																												
																												
																												
																												
																												
																												
																												
																												
																												
																												
																												
																												
																												
																												
																												
																												
																												
																												
																												
																												
																												
																												
																												
																												
																												
																												
																												
																												
																												
																												
																												
																												
																												
																												
																												
																												
																												
																												
																												
																												
																												
																												
																												
																												
																												
																												
																												
																												
																												
																												
																												
																												
																												
																												
																												
																												
																												
																												
																												
																												
																												
																												
																												
																												
																												
																												
																												
																												
																												
																												
																												
																												
																												
																												
																												
																												
																												
																												
																												
																												
																												
																												
																												
																												
																												
																												
																												
																												
																												
																												
																												
																												
																												
																												
																												
																												
																												
																												
																												
																												
																												
																												
																												
																												
																												
																												
																												
																												
																												
																												
																												
																												
																												
																												
																												
																												
																												
																												
																												
																												
																												
																												
																												
																												
																												
																												
																												
																												
																												
																												
																												
																												
																												
																												
																												
																												
																												
																												
																												
																												
																												
																												
																												
																												
																												
																												
																												
																												
																												
																												
																												
																												
																												
																												
																												
																												
																												
																												
																												
																												
																												
																												
																												
																												
																												
																												
																												
																												
																												
																												
																												
																												
																												
																												
																												
																												
																												
																												
																												
																												
																												
																												
																												
																												
																												
																												
																												
																												
																												
																												
																												
																												
																												
																												
																												
																												
																												
																												
																												
																												
																												
																												
																												
																												
																												
																												
																												
																												
																												
																												
																												
																												
																												
																												
																												
																												
																												
																												
																												
																												
																												
																												
																												
																												
																												
																												
																												
																												
																												
																												
																												
																												
																												
																												
																												
																												
																												
																												
																												
																												
																												
																												
																												
																												
																												
																												
																												
																												
																												
																												
																												
																												
																												
																												
																												
																												
																												
																												
																												
																												
																												
																												
																												
																												
																												
																												
																												
																												
																												
																												
																												
																												
																												
																												
																												
																												
																												
																												
																												
																												
																												
																												
																												
																												
																												
																												
																												
																												
																												
																												
																												
																												
																												
																												
																												
																												
																												
																												
																												
																												
																												
																												
																												
																												
																												
																												
																												
																												
																												
																												
																												
																												
																												
																												
																												
																												
																												
																												
																												
																												
																												
																												
																												
																												
																												
																												
																												
																												
																												
																												
																												
																												
																												
																												
																												
																												
																												
																												
																												
																												
																												
																												
																												
																												
																												
																												
																												
																												
																												
																												
																												
																												
																												
																												
																												
																												
																												
																												
																												
																												
																												
																												
																												
																												
																												
																												
																												
																												
																												
																												
																												
																												
																												
																												
																												
																												
																												
																												
																												
																												
																												
																												
																												
																												
																												
																												
																												
																												
																												
																												
																												
																												
																												
																												
																												
																												
																												
																												
																												
																												
																												
																												
																												
																												
																												
																												
																												
																												
																												
																												
																												
																												
																												
																												
																												
																												
																												
																												
																												
																												
																												
																												
																												
																												
																												
																												
																												
																												
																												
																												
																												
																												
																												
																												
																												
																												
																												
																												
																												
																												
																												
																												
																												
																												
																												
																												
																												
																												
																												
																												
																												
																												
																												
																												
																												
																												
																												
																												
																												
																												
																												
																												
																												
																												
																												
																												
																												
																												
																												
																												
																												
																												
																												
																												
																												
																												
																												
																												
																												
																												
																												
																												
																												
																												
																												
																												
																												
																												
																												
																												
																												
																												
																												
																												
																												
																												
																												
																												
																												
																												
																												
																												
																												
																												
																												
																												
																												
																												
																												
																												
																												
																												
																												
																												
																												
																												
																												
																												
																												
																												
																												
																												
																												
																												
																												
																												
																												
																												
																												
																												
																												
																												
																												
																												
																												
																												
																												
																												
																												
																												
																												
																												
																												
																												
																												
																												
																												
																												
																												
																												
																												
																												
																												
																												
																												
																												
																												
																												
																												
																												
																												
																												
																												
																												
																												
																												
																												
																												
																												
																												
																												
																												
																												
																												
																												
																												
																												
																												
																												
																												
																												
																												
																												
																												
																												
																												
																												
																												
																												
																												
																												
																												
																												
																												
																												
																												
																												
																												
																												
																												
																												
																												
																												
																												
																												
																												
																												
																												
																												
																												
																												
																												
																												
																												
																												
																												
																												
																												
																												
																												
																												
																												
																												
																												
																												
																												
																												
																												
																												
																												
																												
																												
																												
																												
																												
																												
																												
																												
																												
																												
																												
																												
																												
																												
																												
																												
																												
																												
																												
																												
																												
																												
																												
																												
																												
																												
																												
																												
																												
																												
																												
																												
																												
																												
																												
																												
																												
																												
																												
																												
																												
																												
																												
																												
																												
																												
																												
																												
																												
																												
																												
																												
																												
																												
																												
																												
																												
																												
																												
																												
																												
																												
																												
																												
																												
																												
																												
																												
																												
																												
																												
																												
																												
																												
																												
																												
																												
																												
																												
																												
																												
																												
																												
																												
																												
																												
																												
																												
																												
																												
																												
																												
																												
																												
																												
																												
																												
																												
																												
																												
																												
																												
																												
																												
																												
																												
																												
																												
																												
																												
																												
																												
																												
																												
																												
																												
																												
																												
																												
																												
																												
																												
																												
																												
																												
																												
																												
																												
																												
																												
																												
																												
																												
																												
																												
																												
																												
																												
																												
																												
																												
																												
																												
																												
																												
																												
																												
																												
																												
																												
																												
																												
																												
																												
																												
																												
																												
																												
																												
																												
																												
																												
																												
																												
																												
																												
																												
																												
																												
																												
																												
																												
																												
																												
																												
																												
																												
																												
																												
																												
																												
																												
																												
																												
																												
																												
																												
																												
																												
																												
																												
																												
																												
																												
																												
																												
																												
																												
																												
																												
																												
																												
																												
																												
																												
																												
																												
																												
																												
																												
																												
																												
																												
																												
																												
																												
																												
																												
																												
																												
																												
																												
																												
																												
																												
																												
																												
																												
																												
																												
																												
																												
																												
																												
																												
																												
																												
																												
																												
																												
																												
																												
																												
																												
																												
																												
																												
																												
																												
																												
																												
																												
																												
																												
																												
																												
																												
																												
																												
																												
																												
																												
																												
																												
																												
																												
																												
																												
																												
																												
																												
																												
																												
																												
																												
																												
																												
																												
																												
																												
																												
																												
																												
																												
																												
																												
																												
																												
																												
																												
																												
																												
																												
																												
																												
																												
																												
																												
																												
																												
																												
																												
																												
																												
																												
																												
																												
																												
																												
																												
																												
																												
																												
																												
																												
																												
																												
																												
																												
																												
																												
																												
																												
																												
																												
																												
																												
																												
																												
																												
																												
																												
																												
																												
																												
																												
																												
																												
																												
																												
																												
																												
																												
																												
																												
																												
																												
																												
																												
																												
																												
																												
																												
																												
																												
																												
																												
																												
																												
																												
																												
																												
																												
																												
																												
																												
																												
																												
																												
																												
																												
																												
																												
																												
																												
																												
																												
																												
																												
																												
																												
																												
																												
																												
																												
																												
																												
																												
																												
																												
																												
																												
																												
																												
																												
																												
																												
																												
																												
																												
																												
																												
																												
																												
																												
																												
																												
																												
																												
																												
																												
																												
																												
																												
																												
																												
																												
																												
																												
																												
																												
																												
																												
																												
																												
																												
																												
																												
																												
																												
																												
																												
																												
																												
																												
																												
																												
																												
																												
																												
																												
																												
																												
																												
																												
																												
																												
																												
																												
																												
																												
																												
																												
																												
																												
																												
																												
																												
																												
																												
																												
																												
																												
																												
																												
																												
																												
																												
																												
																												
																												
																												
																												
																												
																												
																												
																												
																												
																												
																												
																												
																												
																												
																												
																												
																												
																												
																												
																												
																												
																												
																												
																												
																												
																												
																												
																												
																												
																												
																												
																												
																												
																												
																												
																												
																												
																												
																												
																												
																												
																												
																												
																												